Аэропорт Абакан	ABA	Россия
Аэропорт Актау	SCO	Казахстан
Аэропорт Актобе	AKX	Казахстан
Аэропорт Алдан	ADH	Россия
Аэропорт Алматы	ALA	Казахстан
Аэропорт Амдерма	AMV	Россия
Аэропорт Анадырь	DYR	Россия
Аэропорт Анапа	AAQ	Россия
Аэропорт Андижан	AZN	Узбекистан
Аэропорт Апатиты	KVK	Россия
Аэропорт Архангельск (Талаги)	ARH	Россия
Аэропорт Астрахань	ASF	Россия
Аэропорт Атырау	GUW	Казахстан
Аэропорт Ашхабад	ASB	Туркменистан
Аэропорт Баку (Гейдар Алиев)	GYD	Азербайджан
Аэропорт Балхаш	BHХ	Казахстан
Аэропорт Барнаул	BAX	Россия
Аэропорт Батагай	BQJ	Россия
Аэропорт Батуми (Чорох)	BUS	Грузия
Аэропорт Бегишево	NBC	Россия
Аэропорт Белая гора	BGN	Россия
Аэропорт Белгород	EGO	Россия
Аэропорт Белоярский	EYK	Россия
Аэропорт Белушье		Россия
Аэропорт Белькачи (Правый)		Россия
Аэропорт Береговой		Россия
Аэропорт Березово	EZV	Россия
Аэропорт Беринговский		Россия
Аэропорт Благовещенск	BQS	Россия
Аэропорт Бованенково	BVJ	Россия
Аэропорт Богородское	BQG	Россия
Аэропорт Богучаны		Россия
Аэропорт Бодайбо	ODO	Россия
Аэропорт Бомнак		Россия
Аэропорт Боралдай	BXJ	Казахстан
Аэропорт Борисполь	KBP	Украина
Аэропорт Братск	BTK	Россия
Аэропорт Брест	BQT	Беларусь
Аэропорт Брянск	BZK	Россия
Аэропорт Бугрино		Россия
Аэропорт Бугульма	UUA	Россия
Аэропорт Бугуруслан (Главный)		Россия
Аэропорт Бугуруслан (Северный)		Россия
Аэропорт Бухара	BHK	Узбекистан
Аэропорт Ванавара		Россия
Аэропорт Варандей		Россия
Аэропорт Великий Устюг	VUS	Россия
Аэропорт Вентспилс	VNT	Латвия
Аэропорт Верхневилюйск	VHV	Россия
Аэропорт Верхняя Золотица		Россия
Аэропорт Вижас		Россия
Аэропорт Вильнюс	VNO	Литва
Аэропорт Вилюйск	VYI	Россия
Аэропорт Витебск	VTB	Беларусь
Аэропорт Владивосток	VVO	Россия
Аэропорт Владикавказ	OGZ	Россия
Аэропорт Владимир		Россия
Аэропорт Внуково	VKO	Россия
Аэропорт Вожгора		Россия
Аэропорт Волгоград	VOG	Россия
Аэропорт Вологда	VGD	Россия
Аэропорт Волоковая		Россия
Аэропорт Воркута	VKT	Россия
Аэропорт Воронеж	VOZ	Россия
Аэропорт Габала	GBB	Азербайджан
Аэропорт Гагарин	GSV	Россия
Аэропорт Геленджик	GDZ	Россия
Аэропорт Гомель	GME	Беларусь
Аэропорт Горно-Алтайск	RGK	Россия
Аэропорт Горный		Россия
Аэропорт Гродно	GNA	Беларусь
Аэропорт Грозный	GRV	Россия
Аэропорт Гыда		Россия
Аэропорт Гянджа	KVD	Азербайджан
Аэропорт Дашогуз	TAZ	Туркменистан
Аэропорт Депутатский	DPT	Россия
Аэропорт Диксон	DKS	Россия
Аэропорт Днепропетровск	DNK	Украина
Аэропорт Долгощелье		Россия
Аэропорт Домодедово	DME	Россия
Аэропорт Душанбе	DYU	Таджикистан
Аэропорт Елизово	PKC	Россия
Аэропорт Енисейск	EIE	Россия
Аэропорт Ербогачён	ERG	Россия
Аэропорт Жезказган	DZN	Казахстан
Аэропорт Жиганск	ZIX	Россия
Аэропорт Житомир (Смоковка)	ZTR	Украина
Аэропорт Жуковский (Раменское)	ZIA	Россия
Аэропорт Жуляны (Киев)	IEV	Украина
Аэропорт Залив Креста		Россия
Аэропорт Запорожье	OZH	Украина
Аэропорт Зарафшан	AFS	Узбекистан
Аэропорт Звартноц (Ереван)	EVN	Армения
Аэропорт Зея		Россия
Аэропорт Зырянка	ZKP	Россия
Аэропорт Иваново	IWA	Россия
Аэропорт Ивано-Франковск	IFO	Украина
Аэропорт Игарка	IAA	Россия
Аэропорт Игрим	IRM	Россия
Аэропорт Ижевск	IJK	Россия
Аэропорт Индига		Россия
Аэропорт Инта	INA	Россия
Аэропорт Иркутск	IKT	Россия
Аэропорт Иссык-Куль	IKU	Кыргызстан
Аэропорт Йошкар-Ола	JOK	Россия
Аэропорт Кавалерово	KVR	Россия
Аэропорт Казань	KZN	Россия
Аэропорт Калачинск		Россия
Аэропорт Калининград	KGD	Россия
Аэропорт Калуга	KLF	Россия
Аэропорт Каменка		Россия
Аэропорт Караганда (Сары-Арка)	KGF	Казахстан
Аэропорт Каракол	KPJ	Кыргызстан
Аэропорт Каратайка		Россия
Аэропорт Карши	KSQ	Узбекистан
Аэропорт Каунас	KUN	Литва
Аэропорт Кемерово	KEJ	Россия
Аэропорт Кепервеем		Россия
Аэропорт Киран		Россия
Аэропорт Киренск	KCK	Россия
Аэропорт Киров	KVX	Россия
Аэропорт Кихну		Эстония
Аэропорт Кишинев	KIV	Молдова
Аэропорт Когалым	KGP	Россия
Аэропорт Кодинск		Россия
Аэропорт Койда		Россия
Аэропорт Койнас		Россия
Аэропорт Кокшетау	KOV	Казахстан
Аэропорт Кольцово	SVX	Россия
Аэропорт Комсомольск-на-Амуре	KXK	Россия
Аэропорт Кондинское		Россия
Аэропорт Костанай	KSN	Казахстан
Аэропорт Костомукша		Россия
Аэропорт Кострома	KMW	Россия
Аэропорт Коткино		Россия
Аэропорт Котлас	KSZ	Россия
Аэропорт Краснодар	KRR	Россия
Аэропорт Красноселькуп	KKQ	Россия
Аэропорт Красноярск	KJA	Россия
Аэропорт Красноярск (Северный)	СВЫ	
Аэропорт Красный Кут		Россия
Аэропорт Кривой Рог	KWG	Украина
Аэропорт Куляб	TJU	Таджикистан
Аэропорт Курган	KRO	Россия
Аэропорт Курган-Тюбе	KQT	Таджикистан
Аэропорт Курессааре	URE	Эстония
Аэропорт Курск	URS	Россия
Аэропорт Кызыл	KYZ	Россия
Аэропорт Кызылорда	KZO	Казахстан
Аэропорт Кярдла	KDL	Эстония
Аэропорт Лабожское		Россия
Аэропорт Лаврентия		Россия
Аэропорт Ленкорань	LLK	Азербайджан
Аэропорт Ленск	ULK	Россия
Аэропорт Летняя Золотица		Россия
Аэропорт Лешуконское	LDG	Россия
Аэропорт Лиепая	LPX	Латвия
Аэропорт Липецк	LPK	Россия
Аэропорт Лопшеньга		Россия
Аэропорт Львов	LWO	Украина
Аэропорт Магадан	GDX	Россия
Аэропорт Маган	GYG	Россия
Аэропорт Магас	IGT	Россия
Аэропорт Магнитогорск	MQF	Россия
Аэропорт Мама		Россия
Аэропорт Манас Бишкек	FRU	Кыргызстан
Аэропорт Манилы		Россия
Аэропорт Марково	KVM	Россия
Аэропорт Мар-Кюель		Россия
Аэропорт Мары	MYP	Туркменистан
Аэропорт Махачкала	MCX	Россия
Аэропорт Мезень		Россия
Аэропорт Менделеево	DEE	Россия
Аэропорт Мильково		Россия
Аэропорт Минеральные Воды	MRV	Россия
Аэропорт Минск	MSQ	Беларусь
Аэропорт Мирный	MJZ	Россия
Аэропорт Могилев	MVQ	Беларусь
Аэропорт Мосеево		Россия
Аэропорт Мотыгино		Россия
Аэропорт Мурманск	MMK	Россия
Аэропорт Мыс Каменный	YMK	Россия
Аэропорт Навои	NVI	Узбекистан
Аэропорт Надым	NYM	Россия
Аэропорт Нальчик	NAL	Россия
Аэропорт Наманаган	NMA	Узбекистан
Аэропорт Нарьян-Мар	NNM	Россия
Аэропорт Нахичевань	NAJ	Азербайджан
Аэропорт Нелькан		Россия
Аэропорт Нерюнгри	NER	Россия
Аэропорт Несь		Россия
Аэропорт Нижнеангарск		Россия
Аэропорт Нижневартовск	NJC	Россия
Аэропорт Нижнеудинск		Россия
Аэропорт Нижний Новгород	GOJ	Россия
Аэропорт Нижняя Пёша		Россия
Аэропорт Николаев	NLV	Украина
Аэропорт Николаевск-на-Амуре	NLI	Россия
Аэропорт Никольское		Россия
Аэропорт Новокузнецк	NOZ	Россия
Аэропорт Новый Уренгой	NUX	Россия
Аэропорт Ноглики	NGK	Россия
Аэропорт Норильск	NSK	Россия
Аэропорт Ноябрьск	NOJ	Россия
Аэропорт Нукус	NCU	Узбекистан
Аэропорт Нур-Султан	NQZ	Казахстан
Аэропорт Нюрба	NYR	Россия
Аэропорт Нягань	NYA	Россия
Аэропорт Одесса	ODS	Украина
Аэропорт Озерная		Россия
Аэропорт Октябрьский		Россия
Аэропорт Олёкминск	OLZ	Россия
Аэропорт Олема		Россия
Аэропорт Оленёк	ONK	Россия
Аэропорт Ома		Россия
Аэропорт Омолон		Россия
Аэропорт Омск	OMS	Россия
Аэропорт Омсукчан		Россия
Аэропорт Онега		Россия
Аэропорт Оренбург	REN	Россия
Аэропорт Орск	OSW	Россия
Аэропорт Оссора		Россия
Аэропорт Остафьево	OSF	Россия
Аэропорт Оха	OHH	Россия
Аэропорт Охотск	OHO	Россия
Аэропорт Ош	OSS	Кыргызстан
Аэропорт Павлодар	PWQ	Казахстан
Аэропорт Палана		Россия
Аэропорт Паланга	PLQ	Литва
Аэропорт Парзиван	ZTU	Азербайджан
Аэропорт Пахачи		Россия
Аэропорт Певек	PWE	Россия
Аэропорт Пенза	PEZ	Россия
Аэропорт Пермь	PEE	Россия
Аэропорт Пертоминск		Россия
Аэропорт Петрозаводск	PES	Россия
Аэропорт Петрозаводск (Пески)		Россия
Аэропорт Петропавловск	PPK	Казахстан
Аэропорт Печора	PEX	Россия
Аэропорт Пластун	TLY	Россия
Аэропорт Платов (Ростов-на-Дону)	ROV	Россия
Аэропорт Плеханово (Тюмень)		Россия
Аэропорт Подкаменная Тунгуска	TGP	Россия
Аэропорт Полина Осипенко		Россия
Аэропорт Полтава	PLV	Украина
Аэропорт Полярный	PYJ	Россия
Аэропорт Провидения Бухта	PVS	Россия
Аэропорт Псков	PKV	Россия
Аэропорт Пулково	LED	Россия
Аэропорт Пунерма		Россия
Аэропорт Пярну	EPU	Эстония
Аэропорт Рига	RIX	Латвия
Аэропорт Ровно	RWN	Украина
Аэропорт Рухну		Эстония
Аэропорт Ручьи		Россия
Аэропорт Сабетта	SBT	Россия
Аэропорт Саккырыр	SUK	Россия
Аэропорт Салехард	SLY	Россия
Аэропорт Самара	KUF	Россия
Аэропорт Самарканд	SKD	Узбекистан
Аэропорт Сангары		Россия
Аэропорт Саранск	SKX	Россия
Аэропорт Саскылах	SYS	Россия
Аэропорт Сасово		Россия
Аэропорт Сафоново		Россия
Аэропорт Свободный		Россия
Аэропорт Северо-Енисейск		Россия
Аэропорт Северо-Эвенск	SWV	Россия
Аэропорт Сеймчан		Россия
Аэропорт Семипалатинск (Жанасемей)	PLX	Казахстан
Аэропорт Сергели		Узбекистан
Аэропорт Симферополь	SIP	Россия
Аэропорт Снопа		Россия
Аэропорт Соболево		Россия
Аэропорт Советская Гавань	GVN	Россия
Аэропорт Советский	OVS	Россия
Аэропорт Соловки	CSH	Россия
Аэропорт Сочи	AER	Россия
Аэропорт Сояна		Россия
Аэропорт Среднеколымск	SEK	Россия
Аэропорт Ставрополь	STW	Россия
Аэропорт Старый Оскол		Россия
Аэропорт Стрежевой	SWT	Россия
Аэропорт Сумы	UMY	Украина
Аэропорт Сунтар	SUY	Россия
Аэропорт Сургут	SGC	Россия
Аэропорт Сыктывкар	SCW	Россия
Аэропорт Тазовский		Россия
Аэропорт Таксимо		Россия
Аэропорт Талакан	TLK	Россия
Аэропорт Талдыкорган	TDK	Казахстан
Аэропорт Таллинн	TLL	Эстония
Аэропорт Тамбов	TBW	Россия
Аэропорт Тараз (Аулие-Ата)	DMB	Казахстан
Аэропорт Тарко-Сале	TQL	Россия
Аэропорт Тарту	TAY	Эстония
Аэропорт Тас-Юрях		Россия
Аэропорт Ташкент	TAS	Узбекистан
Аэропорт Тбилиси	TBS	Грузия
Аэропорт Тверь (Змеёво)		Россия
Аэропорт Термез	TMJ	Узбекистан
Аэропорт Тернополь	TNL	Украина
Аэропорт Тигиль		Россия
Аэропорт Тикси	IKS	Россия
Аэропорт Тиличики		Россия
Аэропорт Тобольск	TOX	Россия
Аэропорт Толмачево	OVB	Россия
Аэропорт Толька		Россия
Аэропорт Томск	TOF	Россия
Аэропорт Тура (Горный)		Россия
Аэропорт Тура (МВЛ)		Россия
Аэропорт Туркменабат	CRZ	Туркменистан
Аэропорт Туркменбаши	KRW	Туркменистан
Аэропорт Туруханск	THX	Россия
Аэропорт Тында	TYD	Россия
Аэропорт Тюмень	TJM	Россия
Аэропорт Ужгород	UDJ	Украина
Аэропорт Улан-Удэ	UUD	Россия
Аэропорт Ульяновск (Баратаевка)	ULV	Россия
Аэропорт Ульяновск (Восточный)	ULY	Россия
Аэропорт Урай	URJ	Россия
Аэропорт Уральск	URA	Казахстан
Аэропорт Ургенч	UGC	Узбекистан
Аэропорт Уренгой	UEN	Россия
Аэропорт Усинск	USK	Россия
Аэропорт Усть-Каменогорск	UKK	Казахстан
Аэропорт Усть-Камчатск		Россия
Аэропорт Усть-Кара		Россия
Аэропорт Усть-Куйга	UKG	Россия
Аэропорт Усть-Кут	UKX	Россия
Аэропорт Усть-Мая	UMS	Россия
Аэропорт Усть-Нера	USP	Россия
Аэропорт Усть-Хайрюзово		Россия
Аэропорт Усть-Цильма	UTS	Россия
Аэропорт Уфа	UFA	Россия
Аэропорт Ухта	UCT	Россия
Аэропорт Февральск		Россия
Аэропорт Фергана	FEG	Узбекистан
Аэропорт Хабаровск	KHV	Россия
Аэропорт Хабаровск (МВЛ)		Россия
Аэропорт Хандыга	KDY	Россия
Аэропорт Ханты-Мансийск	HMA	Россия
Аэропорт Харута		Россия
Аэропорт Харьков (Основа)	HRK	Украина
Аэропорт Хатанга	HTG	Россия
Аэропорт Хвойный		Россия
Аэропорт Херпучи		Россия
Аэропорт Херсон	KHE	Украина
Аэропорт Хонуу (Мома)	MMW	Россия
Аэропорт Хорей-Вер		Россия
Аэропорт Худжанд	LBD	Таджикистан
Аэропорт Ценогора		Россия
Аэропорт Чара		Россия
Аэропорт Чебоксары	CSY	Россия
Аэропорт Челябинск	CEK	Россия
Аэропорт Черемшанка		Россия
Аэропорт Череповец	CEE	Россия
Аэропорт Черкассы	CKC	Украина
Аэропорт Черновцы	CWC	Украина
Аэропорт Черное		Россия
Аэропорт Черский	CYX	Россия
Аэропорт Чижа		Россия
Аэропорт Чита	HTA	Россия
Аэропорт Чокурдах	CKH	Россия
Аэропорт Чумикан		Россия
Аэропорт Шахтерск	EKS	Россия
Аэропорт Шереметьево	SVO	Россия
Аэропорт Ширак (Гюмри)	LWN	Армения
Аэропорт Шойна		Россия
Аэропорт Шушенское		Россия
Аэропорт Шымкент	CIT	Казахстан
Аэропорт Шяуляй	SQQ	Литва
Аэропорт Экимчан		Россия
Аэропорт Элиста	ESL	Россия
Аэропорт Эребуни (Ереван)		Армения
Аэропорт Юбилейный		Казахстан
Аэропорт Южно-Сахалинск	UUS	Россия
Аэропорт Якутск	YKS	Россия
Аэропорт Ямбург		Россия
Аэропорт Ярославль	IAR	Россия
Аэропорт Ясный (Итуруп)	ITU	Россия
Аэропорт Тираны	TIA	Албания
Аэропорт Грац	GRZ	Австрия
Аэропорт Инсбрук	INN	Австрия
Аэропорт Клагенфурт	KLU	Австрия
Аэропорт Линц	LNZ	Австрия
Аэропорт Зальцбурга	SZG	Австрия
Венский Аэропорт	VIE	Австрия
Аэропорт Антверпен	ANR	Бельгия
Аэропорт Брюсселя	BRU	Бельгия
Аэропорт Шарлеруа	CRL	Бельгия
Аэропорт Льежа	LGG	Бельгия
Аэропорт Остенде Брюгге	OST	Бельгия
Аэропорт Сараево	SJJ	Босния и Герцеговина
Аэропорт Тузла	TZL	Босния и Герцеговина
Аэропорт Бургас	BOJ	Болгария
Аэропорт София	SOF	Болгария
Аэропорт Варна	VAR	Болгария
Аэропорт Дубровник	DBV	Хорватия
Аэропорт Пула	PUY	Хорватия
Аэропорт Сплит	SPU	Хорватия
Задар Аэропорт	ZAD	Хорватия
Аэропорт Загреба	ZAG	Хорватия
Аэропорт Ларнаки	LCA	Кипр
Аэропорт Пафос	PFO	Кипр
Аэропорт Брно	BRQ	Чехия
Пражский Аэропорт	PRG	Чехия
Аэропорт Ольборг	AAL	Дания
Аэропорт Орхус	AAR	Дания
Аэропорт Биллунн	BLL	Дания
Аэропорт Копенгаген	CPH	Дания
Аэропорт Хельсинки Вантаа	HEL	Финляндия
Аэропорт Оулу	OUL	Финляндия
Аэропорт Рованиеми	RVN	Финляндия
Аэропорт Тампере	TMP	Финляндия
Аэропорт Турку	TKU	Финляндия
Аэропорт Вааса	VAA	Финляндия
Аэропорт Аяччо	AJA	Франция
Аэропорт Базель Мюлуз Фрайбург	BSL, MLH, EAP	Франция
Аэропорт Бастия	BIA	Франция
Аэропорт Бержерак	EGC	Франция
Аэропорт Биарриц	BIQ	Франция
Аэропорт Бордо	BOD	Франция
Аэропорт Брест Бретань	BES	Франция
Аэропорт Фигари Южная Корсика	FSC	Франция
Аэропорт Лилля	LIL	Франция
Аэропорт Лион-Сент-Экзюпери	LYS	Франция
Аэропорт Марсель	MRS	Франция
Аэропорт Монпелье	MPL	Франция
Аэропорт Нант	NTE	Франция
Аэропорт Ниццы	NCE	Франция
Аэропорт Париж Бове	BVA	Франция
Аэропорт Париж Шарль де Голль	CDG	Франция
Аэропорт Париж Орли	ORY	Франция
Аэропорт Страсбург	SXB	Франция
Аэропорт Тулон-Йер	TLN	Франция
Аэропорт Тулуза Бланьяк	TLS	Франция
Аэропорт Альгой Мемминген	FMM	Германия
Аэропорт Берлин Бранденбург	BER	Германия
Аэропорт Берлин Шенефельд	SXF	Германия
Аэропорт Берлин Тегель	TXL	Германия
Аэропорт Бремен	BRE	Германия
Аэропорт Кельн Бонн	CGN	Германия
Аэропорт Дортмунд	DTM	Германия
Аэропорт Дрездена	DRS	Германия
Аэропорт Дюссельдорфа	DUS	Германия
Аэропорт Франкфурт	FRA	Германия
Аэропорт Фридрихсхафен	FDH	Германия
Аэропорт Хан	HHN	Германия
Аэропорт Гамбурга	HAM	Германия
Аэропорт Ганновер	HAJ	Германия
Аэропорт Карлсруэ Баден-Баден	FKB	Германия
Аэропорт Лейпциг Галле	LEJ	Германия
Аэропорт Мюнхен	MUC	Германия
Аэропорт Мюнстер Оснабрюк	FMO	Германия
Аэропорт Нюрнберг	NUE	Германия
Аэропорт Падерборн Липпштадт	PAD	Германия
Аэропорт Штутгарта	STR	Германия
Аэропорт Веце	NRN	Германия
Аэропорт Афины	ATH	Греция
Аэропорт Ханья	CHQ	Греция
Аэропорт Корфу	CFU	Греция
Аэропорт Ираклион	HER	Греция
Аэропорт Кос	KGS	Греция
Аэропорт Миконос	JMK	Греция
Аэропорт Родос	RHO	Греция
Аэропорт Санторини	JTR	Греция
Аэропорт Салоники	SKG	Греция
Аэропорт Закинфа	ZTH	Греция
Аэропорт Будапешт	BUD	Венгрия
Аэропорт Дебрецен	DEB	Венгрия
Аэропорт Кефлавик	KEF	Исландия
Аэропорт Корк	ORK	Ирландия
Аэропорт Дублин	DUB	Ирландия
Аэропорт Ирландия Вест Стук	NOC	Ирландия
Аэропорт Керри	KIR	Ирландия
Аэропорт Шеннон	SNN	Ирландия
Аэропорт Альгеро	AHO	Италия
Аэропорт Анкона	AOI	Италия
Аэропорт Бари	BRI	Италия
Аэропорт Бергамо	BGY	Италия
Аэропорт Болонья	BLQ	Италия
Аэропорт Бриндизи	BDS	Италия
Аэропорт Кальяри	CAG	Италия
Аэропорт Катания Фонтанаросса	CTA	Италия
Аэропорт Комизо	CIY	Италия
Аэропорт Флоренции	FLR	Италия
Аэропорт Генуя	GOA	Италия
Аэропорт Ламеция Терме	SUF	Италия
Аэропорт Милан Линате	LIN	Италия
Аэропорт Милан Мальпенса	MXP	Италия
Аэропорт Неаполь	NAP	Италия
Аэропорт Ольбия Коста Смеральда	OLB	Италия
Аэропорт Палермо	PMO	Италия
Аэропорт Перуджа	PEG	Италия
Аэропорт Пескара	PSR	Италия
Аэропорт Пизы	PSA	Италия
Аэропорт Рим Чампино	CIA	Италия
Аэропорт Рим Фьюмичино	FCO	Италия
Аэропорт Трапани	TPS	Италия
Аэропорт Тревизо	TSF	Италия
Аэропорт Турин	TRN	Италия
Аэропорт Венеции	VCE	Италия
Аэропорт Верона	VRN	Италия
Аэропорт Астана	TSE	Казахстан
Аэропорт Люксембург	LUX	Люксембург
Аэропорт Скопье	SKP	Македония
Аэропорт Мальты	MLA	Мальта
Аэропорт Подгорица	TGD	Черногория
Аэропорт Тиват	TIV	Черногория
Аэропорт Амстердам Схипхол	AMS	Нидерланды
Аэропорт Эйндховен	EIN	Нидерланды
Аэропорт Гронинген Эльде	GRQ	Нидерланды
Аэропорт Маастрихт Ахен	MST	Нидерланды
Аэропорт Роттердам Гаага	RTM	Нидерланды
Аэропорт Олесунн	AES	Норвегия
Аэропорт Берген	BGO	Норвегия
Аэропорт Будё	BOO	Норвегия
Аэропорт Хаугесунн	HAU	Норвегия
Аэропорт Кристиансанн	KRS	Норвегия
Аэропорт Осло Гардермуэн	OSL	Норвегия
Аэропорт Сандефьорд Торп	TRF	Норвегия
Аэропорт Ставангер	SVG	Норвегия
Аэропорт Тромсё	TOS	Норвегия
Аэропорт Тронхейм	TRD	Норвегия
Аэропорт Гданьск	GDN	Польша
Аэропорт Катовице	KTW	Польша
Краков Аэропорт	KRK	Польша
Аэропорт Модлин	WMI	Польша
Аэропорт Познани	POZ	Польша
Аэропорт Варшава	WAW	Польша
Аэропорт Вроцлав	WRO	Польша
Аэропорт Фару	FAO	Португалия
Аэропорт Лиссабона	LIS	Португалия
Аэропорт Мадейра	FNC	Португалия
Аэропорт Понта Делгада	PDL	Португалия
Аэропорт Порту	OPO	Португалия
Аэропорт Бухарест Анри Коанда	OTP	Румыния
Аэропорт Клуж-Напока	CLJ	Румыния
Аэропорт Яссы	IAS	Румыния
Аэропорт Тимишоара	TSR	Румыния
Аэропорт Белград Никола Тесла	BEG	Сербия
Аэропорт Ниш	INI	Сербия
Аэропорт Приштины	PRN	Сербия
Аэропорт Братиславы	BTS	Словакия
Аэропорт Любляны	LJU	Словения
Аэропорт Аликанте	ALC	Испания
Аэропорт Альмерия	LEI	Испания
Аэропорт Барселоны	BCN	Испания
Аэропорт Бильбао	BIO	Испания
Аэропорт Фуэртевентура	FUE	Испания
Аэропорт Жироны	GRO	Испания
Аэропорт Гран Канария	LPA	Испания
Аэропорт Ибица	IBZ	Испания
Аэропорт Херес	XRY	Испания
Аэропорт Лансароте	ACE	Испания
Аэропорт Мадрид Барахас	MAD	Испания
Аэропорт Малаги	AGP	Испания
Аэропорт Майорки	PMI	Испания
Аэропорт Менорка	MAH	Испания
Аэропорт Мурсия-Сан-Хавьер	MJV	Испания
Аэропорт Реус	REU	Испания
Аэропорт Сантандер	SDR	Испания
Аэропорт Сантьяго де Компостела	SCQ	Испания
Аэропорт Севильи	SVQ	Испания
Аэропорт Тенерифе Север	TFN	Испания
Тенерифе Южный Аэропорт	TFS	Испания
Аэропорт Валенсии	VLC	Испания
Аэропорт Сарагосы	ZAZ	Испания
Гётеборг Аэропорт Ландветтер	GOT	Швеция
Аэропорт Мальме	MMX	Швеция
Аэропорт Стокгольм Арланда	ARN	Швеция
Аэропорт Стокгольм Бромма	BMA	Швеция
Аэропорт Стокгольм Скавста	NYO	Швеция
Аэропорт Стокгольм Вестерос	VST	Швеция
Аэропорт Берн	BRN	Швейцария
Аэропорт Женева	GVA	Швейцария
Аэропорт Лугано	LUG	Швейцария
Аэропорт Цюриха	ZRH	Швейцария
Аэропорт Адана	ADA	Турция
Аэропорт Анкара Эсенбога	ESB	Турция
Аэропорт Анталии	AYT	Турция
Аэропорт Даламан	DLM	Турция
Аэропорт Ататюрк Стамбул	IST	Турция
Стамбул Новый Аэропорт	ISL	Турция
Аэропорт Стамбул Сабиха Гекчен	SAW	Турция
Аэропорт Измир Аднан Мендерес	ADB	Турция
Аэропорт Милас-Бодрум	BJV	Турция
Аэропорт Абердина	ABZ	Объединенное Королевство
Аэропорт Белфаст Сити	BHD	Объединенное Королевство
Международный аэропорт Белфаст	BFS	Объединенное Королевство
Аэропорт Бирмингем	BHX	Объединенное Королевство
Аэропорт Бристоль	BRS	Объединенное Королевство
Аэропорт Кардифф	CWL	Объединенное Королевство
Аэропорт Ист Мидлендс	EMA	Объединенное Королевство
Эдинбургский Аэропорт	EDI	Объединенное Королевство
Аэропорт Глазго	GLA	Объединенное Королевство
Аэропорт Глазго Прествик	PIK	Объединенное Королевство
Аэропорт Хамберсайд	HUY	Объединенное Королевство
Аэропорт Джерси	JER	Объединенное Королевство
Аэропорт Лидс Брэдфорд	LBA	Объединенное Королевство
Ливерпуль Аэропорт	LPL	Объединенное Королевство
Аэропорт Лондон Сити	LCY	Объединенное Королевство
Аэропорт Лондон Гатвик	LGW	Объединенное Королевство
Аэропорт Лондон Хитроу	LHR	Объединенное Королевство
Аэропорт Лондон Лутон	LTN	Объединенное Королевство
Лондонский Аэропорт Саутенд	SEN	Объединенное Королевство
Аэропорт Лондон Станстед	STN	Объединенное Королевство
Аэропорт Манчестера	MAN	Объединенное Королевство
Аэропорт Саутгемптон	SOU	Объединенное Королевство
Аэропорт Ньюкасл	NCL	Объединенное Королевство
		
		
		
		
		
		
		
		
		
		
		
		
		
		
		
		
		
		
		
		
